12 10
############
#.#........#
#.#.######.#
#.#....#...#
#.###.X#.#.#
#...####.#.#
#.#.#..#.#.#
#.#.#.##.#.#
#o#......#.#
############
